
F 220,100,0
C 225,30,0


NO ./textures/east.xpm
SO ./textures/north.xpm
WE ./textures/south.xpm
EA ./textures/west.xpm


        11111111111111111111111111111111111111111111111111111111
        10000000001100000000000000000000000000000000000000000001
        10110000011100000000000011111111111111111111111111111111
        1001000000000000000000001
111111111011000001110000000000001
1000000000110000011100010011111111111111
11110111111111011100000000000000000000W1
1101011111111101 10100000000111111111111

11000000110101011100000110001
10000000000000001100000010001
10000000000000001101010010001
11000001110101011111011110011
11110111 1110101 101111010001
11111111 1111111 111111111111

